|X|-|-|-|-|-|-|-|-|-|-|-|-|-|-|
| |-|-|     | |-|-|   |-|     |
|       |-| |   |-| | |   |-| |
| |-|-|-|     |     |   |-|-| |
|-|-|-|-|-|-|-|-|-|-|-|-|-|-|0|