|X|-|-|-|-||
| |       ||
| |-|-|-| ||
|   |     ||
|-| |-| | ||
| |     | ||
|-| |-| |-||
|   |     ||
| |-|-|-| ||
|M  |     S|
|-|-|-|-|-||