|X|-|-|-|-|-|-|-|-|-|-|-|-|-|-|
| |-|-|     | |-|-|   |-|     |
|       |-| |   |-| | |   |-| |
| |-|-|-|     |     |   |-|-| S
|-|-|-|-|-|-|-|-|-|-|-|-|-|-|-|